
NO ./textures/north_texture.xpm
SO ./textures/south_texture.xpm
WE ./textures/west_texture.xpm
EA ./textures/east_texture.xpm

F 20, 100, 50
C 225, 30, 0

111111
100001
100001
1000N1
111111