
NO ./textures/north_texture.xpm
SO ./textures/south_texture.xpm
WE ./textures/west_texture.xpm
EA ./textures/east_texture.xpm

F 20, 100, 50
C 225, 30, 0

      111111
      100001
111111100001
100000000001
1010N1111111
100001
111111
