
NO ./textures/north_texture.xpm
SO ./textures/south_texture.xpm
WE ./textures/west_texture.xpm
EA ./textures/east_texture.xpm

F 20, 100, 50
C 225, 30, 0

11111111111111111111
10000000000000000001
10000000000000001111
10000N00000000000001
10000000000000000001
10000111000000000001
10000000000000000001
11111000000000000001
10000000000000000001
10000000000000000001
11111111111111111111