
NO ./textures/sport.xpm
SO ./textures/short_way.xpm
WE ./textures/olga_misha.xpm
EA ./textures/green_team.xpm


F 200, 184, 0
C 0, 128, 255

        1111111111111111111111111
        10000000001100000E0000001
        1011000001110000000100001
        100100000000000000000001
11111111101100000111000000000000111111111
100000000011000001110111111111111
11111111111111111110111111111
111101111111011111110111100101
10000001 1000001 1010000000001
11111111 1111111 1111111100001
11111111 1111111 1111111111111
