NO ./textures/north_texture.xpm
SO ./textures/south_texture.xpm
	 	  		 
WE ./textures/west_texture.xpm
EA ./textures/east_texture.xpm
		 	  	 
F 20, 100, 50
C 225, 30, 0

  111111 11111 11111
11100001 10001 10001
11000111 10001 11111
 1000001110001
110000000000N1
11111111111111