
NO ./textures/north_texture.xpm
SO ./textures/south_texture.xpm

F 20, 200, 0
C 225, 30, 0

WE ./textures/west_texture.xpm
EA ./textures/east_texture.xpm

  111111 11111 11111
11100001 10001 10001
11000111 10001 11111
 1000001110001
11000E00000001
11111111111111
